NO ./textures/north.xpm
SO ./textures/south.xpm
WE ./textures/west.xpm
EA ./textures/east.xpm

S ./textures/sprite.xpm

F 100, 100, 100
C 50, 50, 50


11111111111111111 
10000000000000001
10200000200000201 11111
10000000000000001 
10002000200020001  
11111111111111111

11111

    11111111111111111
    10000000000000001
111110202020S02020201
100000000000000011111
10002000200200001
10000000000000001
10200000200002111
10000000000000001
11111111111111111