NO ./textures/north.xpm
SO ./textures/south.xpm
WE ./textures/west.xpm
EA ./textures/east.xpm

F 20, 50, 70
C 150, 154, 150

S ./textures/sprite.xpm

1111 1
101111
120S21
100001
1201001 111
1111111
