NO ./textures/north.xpm
SO ./textures/south.xpm		
EA ./textures/east.xpm
WE ./textures/west.xpm

F 75, 4, 5    
C 5, 5, 5

S ./textures/sprite.xpm

     11111111111111111111111111111
     10000000000000000000000000001
     10000200000000000000000111111
111111000000000E0000000000001
10000000000020000000000000001
10000002000000000000002000001
10000000000000000000000000001
10111111111111111111111111111
101 
10111111111111111111111111111
10000010000000000000000000001
10000010000000000000000000001
10000000000000000000000100001
10000000000001111111000000001
10000000000001     1000000001
10000000000001   111000000001
10000000000001   100000000001
11111111111111   111111111111
