F 20, 50, 70
C 150, 154, 150

NO  ./textures/north.xpm
SO ./textures/south.xpm
WE ./textures/west.xpm
EA ./textures/east.xpm

S ./textures/sprite.xpm

1111111111
1000000001
1000200001
1000000001
1000N00001
1000000001
1011111101
1000000001
1000000001
1200110021
1000000001
1000000001
1110000111
1001001001
1111100001
1000000001
1001111111
1001000001
1001000001
1001001001
1000001001
1000001001
1111111001
1000001001
1000001001
1000001001
1000001001
1000001001
1000001221
1000001001
1000001001
1000001001
1000001001
1000001001
1000001001
1000001001
1000001001
1111001001
1000001001
1000001001
1000001001
1000001001
1000002001
1000001001
1000001001
1000000001
1000001001
1000000001
1100000001
1010001001
1000010001
1000000001
1111111111
