NO  ./textures/north.xpm
SO ./textures/south.xpm
WE ./textures/west.xpm
EA ./textures/east.xpm

F 20,  50, 70
C 150, 154, 150

1111 1
10011111
1000S01
100001
1001001
1111111
