R 400 400

NO ./assets/north.xpm
SO ./assets/south.xpm
WE ./assets/west.xpm
EA ./assets/east.xpm

S ./assets/sprite.xpm

F 220, 50, 220
C 150, 150, 150

000011111111111
000010000000001
111110000E00001
100000200111111
1000200001
1000000001
1111111111
