R 1280 720

NO ./assets/north.xpm
SO ./assets/south.xpm
WE ./assets/west.xpm
EA ./assets/east.xpm

S ./assets/sprite.xpm

F 100, 100, 100
C 50, 50, 50

1111111111111111111111111111111111111111111111111111111
1 E 2 2 2       2    2          2   2    2   2        1
111111111111111111111111111111111111111111111111111   1
1  22           2222          22 222      22 22 222   1
1   111111111111111111111111111111111111111111111111111
1    2              22222   22  22222           2222  1
111111111111111111111111111111111111111111111111111   1
1   2   2   2   2   2   2   2   2   2   2   2   2   2 1
1   111111111111111111111111111111111111111111111111111
1   2 2 2 2 2 2 2 2 2 2 2 2 2 2 2 2 2 2 2 2 2 2 2 2 2 1
111111111111111111111111111111111111111111111111111   1
1   22222222222222222222222222222222222222222222222   1
1   111111111111111111111111111111111111111111111111111
1   2   2   2   2   2   2   2   2   2   2   2   2   2 1
1  2   2   2   2   2   2   2   2   2   2   2   2   2  1
111111111111111111111111111111111111111111111111111   1
1  222222222222222222222222222222222222222222222222   1
1  222222222222222222222222222222222222222222222222   1
1  222222222222222222222222222222222222222222222222   1
1  222222222222222222222222222222222222222222222222   1
1   111111111111111111111111111111111111111111111111111
1222222222222222222222222222222222222222222222222222221
1222222222222222222222222222222222222222222222222222221
1222222222222222222222222222222222222222222222222222221
1222222222222222222222222222222222222222222222222222221
1222222222222222222222222222222222222222222222222222221
1222222222222222222222222222222222222222222222222222221
1222222222222222222222222222222222222222222222222222221
1222222222222222222222222222222222222222222222222222221
1222222222222222222222222222222222222222222222222222221
1222222222222222222222222222222222222222222222222222221
1222222222222222222222222222222222222222222222222222221
1111111111111111111111111111111111111111111111111111111
