NO	./textures/north.xpm
SO ./textures/south.xpm
WE ./textures/west.xpm
EA ./textures/east.xpm

F 220, 50, 220
C 150, 150, 150

11111111111111111111 11111111111111111111
10000000000000000001 10000000000000000001
10000111111111111111 10N00111111111111111
111111               111111
