NO ./textures/north.xpm
SO ./textures/south.xpm
WE ./textures/west.xpm
EA ./textures/east.xpm

S ./textures/sprite.xpm

F 100, 0, 100
C 150, 150, 150

11111110000000001111111111111111111111111
10000001111111110000020000000000000000001
100S0000002000000000000000000000000002001
10000000000000001111111111111111111000001
11100011111110001000000000000000001000001
00100010000010001000000000000000001000001
00100010000010001000000111111111001000001
00100010000010001000000100000001001020001
00100010000010001000111100020001111000001
00100010000010001000100000000000000000001
00100010000011111000100011111111111111111
00102010000000000000100010000000000000000
11100011111111111111100010000000001111100
10000000000000000000002011111111111000100
10000020000000000000000000000000000000100
11110000111111111111100000000000002000100
00010000100000000000111111111111000000100
00010000100000000000000000000001000000100
00010000111111111111111111111111000000100
00010000000000000000000000000000000000100
00010000200000000000000200000000000200100
00010000000000000000000000000000000000100
00011111111111111111111111111111111111100
