NO ./textures/north.xpm
SO ./textures/south.xpm
WE ./textures/west.xpm
EA ./textures/east.xpm

S ./textures/sprite.xpm

F 100, 100, 100
C 50, 50, 50

11111111111111111111
1                  1
1       S          1
1  2            2  1
1    1  1  1111    1
1    1  1     1    1
1    1111 21111    1
1       1  1    2  1
1   2   1  1111    1
1                  1
1                  1
1                  1
11111111111111111111
