NO ./textures/north.xpm
SO ./textures/south.xpm
WE ./textures/west.xpm
EA ./textures/east.xpm

S ./textures/sprite.xpm

F 50, 50, 50
C 20, 20, 20

11111111111111111111
10000002000000000001
10000000000002002001
10000000200000000001
10002W00020011111111
10000002020010000001
10200000000010000001
10000200000000000001
10000000000000000001
11111111111111111111