NO ./textures/north.xpm
SO ./textures/south.xpm
WE ./textures/west.xpm
EA ./textures/east.xpm
S  ./textures/sprite.xpm
C 255,123,123
F 123,255,123

            1111111
         111110001111
         1100000000111
        111000011111111111
        11100111        111
  1111111000111          111
 11000011000111          111
 110000110000111        1111
 110000110000011111111111111
 110000110000000000000000011
 11000001000000000000000011
 110000000000000W00000000011
 110000110000000000000000001
 110001110000000000000000011
  1111111000001111111110111
        1100000111 111100111
        1100000011  11000111
        1100000001   1000001
        1111111111   1111111
111111111111111111
