R 581 345

NO ./assets/north.xpm
SO ./assets/south.xpm
EA ./assets/east.xpm
WE ./assets/west.xpm

S ./assets/sprite.xpm

F 5, 4, 5
C 5, 5, 5

0000000011111111111
00000000100000000010111111111111
0000111110000N000011100000000001
00001000020000000000000000000001
00001000000000000000000000000001
00001000000000000000000000000001
00001111000000001111100000200001
00000001000000001000100000000001
00000001000000001000100000000001
00000001000000001111100000000001
00000001000000200000000000000001
00000001000000000000000000000001
00000001000000000000000000000001
00000001000000001111111000000001000000000011
00000001000000001000001000000000000000000001
00000001000000001111111000000001111111111111
00000001000000000000000000000001
00000001111111111111111111111111
