NO ./textures/north.xpm
SO ./textures/south.xpm
EA ./textures/east.xpm
WE ./textures/west.xpm

S ./textures/sprite.xpm

F 5, 4, 5
C 5, 5, 5

1111111
1000001
1000001
100N00000
1000001
1000001
1111111
